NO ./textures/wall_metal_1.xpm
SO ./textures/wall_metal_1.xpm
WE ./textures/wall_metal_1.xpm
EA ./textures/wall_metal_1.xpm

C 200,230,255
F 80,60,30

11111
10001
10E01
10001
11111