NO ./textures/wall_metal_1.xpm
SO ./textures/wall_metal_1.xpm
WE ./textures/wall_metal_1.xpm
EA ./textures/wall_metal_1.xpm

C 200,230,255
F 80,60,30

111111111111
100000000001
100000S00001
100000000001
111111111111
