NO ./textures/wall_3_1.xpm
SO ./textures/wall_3_2.xpm
WE ./textures/wall_3_3.xpm
EA ./textures/wall_3_4.xpm

C 200,230,255
F 80,60,30

        1111111111111111111111111
        1001000000100000000000001
        1011000000100000000000001
        1011000E00100000010000001
        1011000000100000010000001
        1011000000100000010000001
        1011000000100000010000001
        1011000000100000010000001
        1000000000000000010000001
111111111011000001110010010000001
100000000011000001110011111111111
1111011111111101110000001
11111111111111011101001011111
11000000110101011100000010001
10000000000000001100000010001
1000000000000000110101001000111
11000001110101011111011110011
11110111 1110101 101111010001
11111111 1111111 111111111111
