NO ./textures/wall_metal_1.xpm
SO ./textures/wall_metal_1.xpm
WE ./textures/wall_metal_1.xpm
EA ./textures/wall_metal_1.xpm

C 200,230,255
F 80,60,30

1111
10E1
1001
1111
