NO ./textures/texture1.xpm
SO ./textures/texture2.xpm
WE ./textures/texture3.xpm
EA ./textures/texture1.xpm

C 200,230,255                 
F 80,60,30

1111111111111111111111111
1001000000100000000000001
1001000000100000000000001
1001000000100000000000001
1111111111111111111111111
