NO ./textures/wall_5_1.xpm
SO ./textures/wall_5_2.xpm
WE ./textures/wall_5_3.xpm
EA ./textures/wall_5_4.xpm

C 200,230,255
F 40,50    ,30

        11111111111
        10000000001
        10000000001
        10000000001
        10000W00001
        10000000001
        10000000001
        10000000001
        11111111111
